################
#111  8888  444#
#111  8888  444#
#11          44#
#              #
#33          55#
#33          55#
#33          55#
#33          55#
#              #
#66          22#
#666  7777  222#
#666  7777  222#
################