################
#          4444#
#111       4444#
#111       4444#
#111           #
#111        555#
#           555#
#           555#
#333        555#
#333           #
#333       2222#
#333       2222#
#          2222#
################