################
#1111      4444#
#1111      4444#
#1111      4444#
#1111      4444#
#              #
#              #
#              #
#              #
#3333      2222#
#3333      2222#
#3333      2222#
#3333      2222#
################