################
#111        555#
#111        555#
#111        555#
#              #
#33          66#
#33          66#
#33          66#
#33          66#
#              #
#444        222#
#444        222#
#444        222#
################