################
#1111      3333#
#1111      3333#
#1111      3333#
#1111      3333#
#              #
#              #
#              #
#              #
#     2222     #
#     2222     #
#     2222     #
#     2222     #
################